EQS = "countries/Equestria.txt"
DRG = "countries/Dragon.txt"
OLE = "countries/Olenia.txt"
CHN = "countries/Changeling.txt"
YAK = "countries/Yakistan.txt"
GRF = "countries/Griffon.txt"
STG = "countries/Stalliongrad.txt"
BUF = "countries/Buffalo.txt"
CRY = "countries/CrystalEmpire.txt"
PLB = "countries/PolarBears.txt"
PNG = "countries/Pinguins.txt"
STL = "countries/StarlightVillage.txt"
NLR = "countries/NewLunarEmpire.txt"
VAN = "countries/Vanhoover.txt"
SCS = "countries/SouthStates.txt"
BAL = "countries/Baltimare.txt"
NMS = "countries/NightSupporters.txt"
CES = "countries/CelestialSupporters.txt"
JUN = "countries/JungleNation.txt"
GFF = "countries/GriffonFrontier.txt"
JAK = "countries/Jakistan.txt"
TEM = "countries/Temple.txt"
SOL = "countries/SolarEmpire.txt"
ZRS = "countries/ZecoranResistance.txt"
CCN = "countries/ChangelingHarmony.txt"
LSP = "countries/LosPegasus.txt"
MAN = "countries/Manehattan.txt" ## Equestrian East Coast
ELF = "countries/EquestriaLiberationFront.txt"

############################ Griffon Continent ####
GRI = "countries/GriffonEmpire.txt"
DED = "countries/DeadCountry.txt"
HLR = "countries/HolyOrder.txt"
FAT = "countries/Fatass.txt"
FAW = "countries/FatassWarlord.txt"
MIT = "countries/Minotauria.txt"
ERI = "countries/HouseErie.txt"
EYR = "countries/HouseEyrie.txt"
SIC = "countries/Sicameon.txt" ### Peaceful Lord jkkk 0)))))
VED = "countries/Vedina.txt" 
CYA = "countries/Cyanolisia.txt"
FRN = "countries/Franmistria.txt"
ARA = "countries/Arantiga.txt"
EQC = "countries/EquestrianColony.txt"
TRD = "countries/TradeFed.txt"
WNG = "countries/Wingbardy.txt"
FEA = "countries/Feathisia.txt"
PYT = "countries/Griffinheim.txt"
HEL = "countries/Adelart.txt"
ROU = "countries/Romau.txt"
AET = "countries/Griefwald.txt"
JER = "countries/Jerklord.txt"
JEB = "countries/Jerkbro.txt"
JFT = "countries/Jerkfather.txt"
JES = "countries/Jerksister.txt"
JRR = "countries/Jerkrelatives.txt"
BOI = "countries/Someboibuthesactuallyevil.txt"
LAK = "countries/Lakelord.txt"
FAL = "countries/Falcor.txt" ## Peaceful Lord <<<<
AVI = "countries/HouseAvian.txt"
POM = "countries/Pomovarra.txt"
VIN = "countries/Vinovia.txt"
YAL = "countries/Yaledom.txt"
ANG = "countries/Angriver.txt"
ZES = "countries/ZebraSettlement.txt"
OLV = "countries/OleniaVikings.txt"
GRW = "countries/GriffonWill.txt"
BRF = "countries/Brodfeld.txt" ## aka losing memelord
BAN = "countries/GriffonBandits.txt"
STW = "countries/Strawberry.txt"
HLQ = "countries/HellquillCountry.txt"
KAT = "countries/KaterinQueendom.txt"
BRZ = "countries/Bronzehill.txt"
FLO = "countries/Flowena.txt"
GRY = "countries/Gryphia.txt"
TAL = "countries/Talouse.txt"
LNS = "countries/Longsword.txt"
LUS = "countries/Lushland.txt"
FIR = "countries/FirtreeCommunes.txt"
FEZ = "countries/Fezera.txt"
MNC = "countries/MountainGriffons.txt"
WAT = "countries/Watertown.txt"
FBK = "countries/Farbrook.txt"
GRU = "countries/Gryphus.txt"
HAU = "countries/Hauklands.txt"
SRS = "countries/SocialistRepublicofSocialists.txt"
NCH = "countries/VillageChangelings.txt"
NTR = "countries/NorthernTribes.txt"
DMT = "countries/DaimondMountain.txt"
LCT = "countries/LakeCity.txt"
RCT = "countries/RiverCity.txt"
NIM = "countries/Nimbusia.txt"
WIT = "countries/Wittenland.txt"
BAK = "countries/Baka.txt"
DEP = "countries/Deponya.txt"
FRE = "countries/Freeponies.txt"
BAR = "countries/Barrd.txt"
EWI = "countries/EventWindego.txt"
LSC = "countries/LongswordCommunist.txt"
LSM = "countries/LongswordMilitary.txt"

#Aquileian Puppets Start Here

JHZ = "countries/HerzlandRepublic.txt"
JNG = "countries/NorthGriffonianRepublic.txt"
JGF = "countries/GriffonstoneRepublic.txt"
JKR = "countries/KarthinianRepublic.txt"
JOS = "countries/OstGriffonianFederalRepublic.txt"
JHP = "countries/HillponyConfederation.txt"
JRV = "countries/RiverFederation.txt"
JAS = "countries/AsterionRepublic.txt"
JEV = "countries/EviConfederation.txt"

#########################



############################## Zebrican Continent ####
HIP = "countries/Hippogriffs.txt"
MGY = "countries/Maregypt.txt"
ABY = "countries/Abyssinia.txt"
BAT = "countries/BatColony.txt"
PCB = "countries/PuertoCaballo.txt"
MDL = "countries/Manedalusia.txt"
TBK = "countries/Tobuck.txt"
WAR = "countries/Warzena.txt"
ZAR = "countries/Zaramanetia.txt"
TSV = "countries/Talonsvaal.txt"
GFS = "countries/GriffonFreeState.txt"
ROA = "countries/Roam.txt"
MCW = "countries/Macawia.txt"
ZAI = "countries/Zair.txt"
ZUM = "countries/Neighmidia.txt"
ZWA = "countries/Zwanda.txt"
ZUG = "countries/Zuganda.txt"
MKS = "countries/Marekush.txt"
TIM = "countries/Timbucktu.txt"
SON = "countries/Songneigh.txt"
HAY = "countries/Haysa.txt"
SLC = "countries/Stormleucid.txt"
CZR = "countries/CentralZebricanRepublic.txt"
SDL = "countries/Saddle Arabia.txt"
SDC = "countries/Arabian Popular Front.txt"
SDF = "countries/National Salvation Movement.txt"
SDS = "countries/Arabian Republic.txt"
EMR = "countries/League Of Four Emirs.txt"
ALO = "countries/Alodmaneia.txt"
MSH = "countries/Mareshasha.txt"
ASS = "countries/Asstyria.txt"
ANS = "countries/Anseruk.txt"
STM = "countries/Stormland.txt"
THU = "countries/Thundaria.txt"
GYZ = "countries/Gyzwindid.txt"
KIR = "countries/Kirin.txt"
KIC = "countries/KirinCommunist.txt"
KIS = "countries/KirinSupremacist.txt"
NVA = "countries/NorthVietmane.txt"
YMN = "countries/Yemane.txt"
MTA = "countries/Maretania.txt"
REE = "countries/Reem.txt"
MSS = "countries/Maressi.txt"
HMR = "countries/Haymar.txt"
OSQ = "countries/Osqat.txt"
KAR = "countries/Karkadannistan.txt"
MTO = "countries/Maretonia.txt"
AES = "countries/Aestlonia.txt"
ZLU = "countries/Zeblu.txt"
HYE = "countries/Hyenia.txt"
GIF = "countries/Giraffia.txt"
CTH = "countries/Colthage.txt"
CDR = "countries/Coltdar.txt"
CVA = "countries/Coltva.txt"
BKH = "countries/Buckhara.txt"
CGI = "countries/Coltagatai.txt"
BLT = "countries/Boltria.txt"
KXN = "countries/KirXang.txt"
KHM = "countries/Khmare.txt"
GAZ = "countries/Gazelleia.txt"
LMB = "countries/Llambet.txt"
SPL = "countries/Stagpal.txt"
IDT = "countries/IceDragons.txt"
HIN = "countries/Hindia.txt"
CTL = "countries/Chital.txt"
SAM = "countries/Sambar.txt"
BRS = "countries/Barasingha.txt"
HRV = "countries/UusiHirvimaa.txt"
DEL = "countries/Delanige.txt"
MEL = "countries/Melahuac.txt"
IDO = "countries/Idowu.txt"
IST = "countries/Istermano.txt"
MAZ = "countries/Mazozi.txt"
YAN = "countries/Yaneo.txt"
CME = "countries/Camelia.txt"
ZOO = "countries/Zongo.txt"
TAI = "countries/Tanaigha.txt"
MQA = "countries/Sambovato.txt"
ZEL = "countries/Zesalampy.txt"
GAR = "countries/Gargoyleia.txt"
CNT = "countries/Centauria.txt"
MER = "countries/LesMeridiennes.txt"
WIN = "countries/Winggarden.txt"
KLG = "countries/Klugetown.txt"
HIE = "countries/Hippone.txt"
TRO = "countries/Trotkart.txt"